NO ./texture/eagle.xpm
SO ./texture/blue_stone.xpm
WE ./texture/mossy.xpm
EA ./texture/wood.xpm
F 255,0,0
C 0,0,0

1111111111111111111111111
1E000000000001
1111111111111111111111111
