NO ./texture/eagle.xpm
SO ./texture/blue_stone.xpm
WE ./texture/mossy.xpm
EA ./texture/wood.xpm

F 255,0,0
C 0,0,0

11111111111111
1E000001
11111111111111
