NO ./texture/eagle.xpm
SO ./texture/blue_stone.xpm
WE ./texture/mossy.xpm
EA ./texture/wood.xpm
F 255,0,255
C 0,255,255

1111111111111111111111111
10000000W000001
1111111111111111111111111
