NO ./texture/eagle.xpm
SO ./texture/blue_stone.xpm
WE ./texture/mossy.xpm
EA ./texture/wood.xpm
DT ./texture/door_0.xpm ./texture/door_1.xpm ./texture/door_2.xpm ./texture/door_3.xpm
F 255,0,255
C 0,255,255

111111111111111111111111
100D000000110000000000001
10110000111100010011D1001
10010000D000001000000000111111111
111111111D11000001110000D00D00001
10000000001100000111D111111111111
11110111111111011100000010011
1111D111111111D111010100101D1
11000000110101011100000010011
10000000000000001100000010001
10000000000000001101010010001
1100N00111010101111101111000111
11110111 1110101 101111010001
   11111111111111111 111111111111
