NO			./textures/1.xpm			
SO                  ./textures/2.xpm     
WE	     		./textures/3.xpm
EA	./textures/4.xpm
F 255,200,200
C 250,200,200
NO ./texture/eagle.xpm
SO ./texture/blue_stone.xpm
WE ./texture/mossy.xpm
EA ./texture/wood.xpm
F 255,0,255
C 0,255,255

111111111111111111111111
1E00000000110000000000001
1011000001110001000000001
1001000000D0001000000000111111111
111111111D11000001110000D00D00001
10000000001100000111D111111111111
11110111111111011100000010001
1111D111111111D11101010010001
11000000110101011100000010001
10000000000000001100000010001
10000000000000001101010010001
1100000111010101111101111000111
11110111 1110101 101111010001
   11111111111111111 111111111111
