NO		   ./textures/1.xpm
SO                  ./textures/2.xpm
WE	./textures/3.xpm
EA	./textures/4.xpm
F 250,200,200
C 250,200,200

111111
110011
10N001
1110011111111111
1111111111111101
1111111111111111

