NO		   ./textures/1.xpm
SO                  ./textures/2.xpm
WE	./textures/3.xpm
EA	./textures/4.xpm
C 0,255,255
F 255,0,255

11111
10101
10S01
10001
11011
10001
11101
10001
11111


