NO ./texture/eagle.xpm
SO ./texture/blue_stone.xpm
WE ./texture/a.xpm
EA ./texture/wood.xpm
DT ./texture/door.xpm
F 255,0,255
C 0,255,255

111111111111111111111111
1E0D000000110000000000001
10110000111100010011D1001
10010000D000001000000000111111111
111111111D11000001110000D00D00001
100000000011000001110111111111111
1111D111111111011100000010001
11110111111111D11101010010001
11000000110101011100000010001
10000000000000001100000010001
10000000000000001101010010001
1100000111010101111101111000111
11110111 1110101 101111010001
   11111111111111111 111111111111
