NO		   ./textures/1.xpm
SO                  ./textures/2.xpm
WE	./textures/3.xpm
EA	./textures/4.xpm
F 250,200,200
C 250,200,200

111111
11001
10N01
111111