NO		   ./textures/1.xpm
SO                  ./textures/2.xpm
WE	./textures/3.xpm
EA	./textures/4.xpm
F 250,200,200


11111
100001
1000N1
11111


