NO			./textures/1.xpm			
SO                  ./textures/2.xpm     
WE	     		./textures/3.xpm
EA	./textures/4.xpm
F 255,200,200
C 250,200,200

1111111
11111011
110000N1
111000111
1100000011
1110000011111111
1111111111111101
1111111111111111
11111
10001
1001111
10001
11111
